Access Mode=Modalità d'accesso
Add another Path, Port, Variable, Label or Device=Aggiungi un altro percorso, Porta,Variabile, Etichetta o Dispositivo
Add Configuration=Aggiungi Configurazione
Add=Aggiungi
Always=Sempre
App to Host=App a Host 
Application=Applicazione
apply update=conferma aggiornamento
Array must be Started to view Docker containers=Array must be **Started** to view Docker containers
Are you sure=Sei sicuro
Autostart=Autoavvio
Back=Indietro
Backup=Backup
Beta=Beta
Books=Libri
By=Di
Categories=Categorie
Check for Updates=Ricerca aggiornamenti
Cloud=Cloud
Config Type=Tipo di configurazione
Configuration not found=Configurazione non trovata
Connection Type=Tipo di connessione
Console shell command=Comando shell console
Container ID=Id Contenitore
Container Path=Percorso Contenitore
Container Port=Porta Contenitore
Container Size=Dimensione Contenitore
Container=Contenitore
CPU Memory load=Carico memoria CPU
CPU Pinning=CPU Pinning
Created=Creato
Default Value=Valore Predefinito
Device=Dispositivo
Display=Display
DNS=DNS
Docker Containers=Contenitori Docker
Docker Hub URL=Docker Hub URL
Docker Service failed to start=Avvio Servizio Docker fallito 
Donation Link=Link Donazione
Donation Text=Testo Donazione
Downloaders= Downloaders 
Edit Configuration=Modifica Configurazione
Exited=Uscita
Extra Parameters=Parametri aggiuntivi
Fixed IP address=Indirizzo IP fisso
force update=forza aggiornamento
FTP=FTP
Game Servers=Game Servers
healthy=in salute
Hide Buttons=Nasconti tasti
Hide docker allocations=Nascondi posizione Docker
Hide more settings=Nascondi altre impostazioni
Home Automation=Home Automation
Host Path=Percorso Host
Host Port=Porta Host
HT=HT
Icon URL=URL Icona
Image ID=ID Immagine
Key=Chiave
Label=Etichetta
latest=ultimo
Management=Gestione
MediaApp=MediaApp
MediaServer=MediaServer
Messenger=Messenger
Missing parameters=Parametri mancanti
Music=Musica
Network Type=Tipo di Rete
No Docker containers installed=Nessun contenitore Docker istallato
of=di
orphan image=immagine orfana
Other=Altro
Overview=Panoramica
Path=Percorso
Pause All=Tutto in pausa
Photos=Foto
Port Mappings= Mappatura Porte 
Port=Porta
Post Arguments=Parametri Porta
Privileged=Privilegi
Productivity=Produttività
Project Page=Pagina del Progetto
Proxy=Proxy
Pulling image= Pulling Immagine
Read Only - Shared=Sola Lettura - Condiviso
Read Only - Slave= Sola Lettura - Slave
Read Only= Sola Lettura
ReadWrite - Condiviso=Lettura/Scrittura - Condiviso
ReadWrite - Slave=Lettura/Scrittura - Slave
rebuild ready=ricostruzione pronta
rebuilding=ricostruzione
Remove template=Rimuovi Template
Removing container=Rimuovi Contenitore
Removing orphan image=Rimuovi immagine orfana
Repository=Repository
Required=Richiesta
Resume All=Riprendi tutto
Save=Salva
Select a template=Seleziona un Template
Select categories=Seleziona categoria
Show docker allocations=Mostra percorsi docker
Show more settings=Mostra altre impostazioni
Stable=Stabile
Start All=Avvia tutto
starting up containers=Contenitori avviati
Stop All=Ferma Tutto
Stopping container=Ferma contenitore
Successfully removed container=Contenitore rimosso con successo
Successfully removed orphan image=immagine orfana rimossa con successo
Successfully stopped container=Contenitore fermato con successo
Support Thread=Discussione di supporto
Template repositories=Template repositories
Template URL=Template URL
Template=Template
The command failed=Comando Fallito
The command finished successfully=Comando terminato con successo
TOTAL DATA PULLED=DATI TOTALI ESTRATTI
Unknown action=azione sconosciuta
Update All=Aggiorna tutto
update ready=aggiornamento pronto
Value=Valore
Variable=Variabile
Video=Video
Voip=Voip
Volume Mappings=Mappature dei volumi
wait=attendere
Was this container created using this plugin=Questo contenitore è stato creato utilizzando questo plug-in
Web=Web
WebUI=WebUI
Writable=Scrivibile
